ა	ɑ
ბ	b
გ	g
დ	d
ე	ɛ
ვ	v
ზ	z
თ	tʰ
ი	ɪ
კ	kʼ
ლ	l
მ	m
ნ	n
ო	ɔ
პ	pʼ
ჟ	ʒ
რ	r
ს	s
ტ	tʼ
ჳ	w
უ	u
ფ	pʰ
ქ	kʰ
ღ	ʁ
ყ	qʼ
შ	ʃ
ჩ	t͡ʃ
ც	t͡s
ძ	d͡z
წ	t͡s
ჭ	t͡ʃ
ხ	χ
ჴ	q
ჯ	d͡ʒ
ჰ	h